2 0 3 2 2 2 2 2 2 2 2 2 2 2 2 2
2 1 3 1 0 1 0 1 0 1 0 1 0 1 0 2
2 0 3 0 1 0 1 0 1 0 1 0 1 0 1 2
2 1 3 3 3 3 0 1 0 1 0 1 0 1 0 2
2 0 4 4 4 4 1 0 1 0 1 0 1 0 1 2
2 1 4 4 4 4 0 1 0 1 0 1 0 1 0 2
2 0 4 4 4 4 1 0 1 0 1 0 1 0 1 2
2 1 0 1 0 1 0 1 0 1 0 1 0 1 0 2
2 0 1 0 1 0 1 0 1 0 1 0 1 0 1 2
2 1 0 1 0 1 0 1 0 1 0 1 0 1 0 2
2 0 1 0 1 0 1 0 1 0 1 0 1 0 1 2
2 2 2 2 2 2 2 2 2 2 2 2 2 2 2 2